School Year,LEA,LEA Name,Position Category,"American Indian or Alaska Native
Female","American Indian or Alaska Native
Male","American Indian or Alaska Native
Nonbinary","American Indian or Alaska Native
Total","Asian
Female","Asian
Male","Asian
Nonbinary","Asian
Total","Black or African American
Female","Black or African American
Male","Black or African American
Nonbinary","Black or African American
Total","Hispanic or Latino
Female","Hispanic or Latino
Male","Hispanic or Latino
Nonbinary","Hispanic or Latino
Total","Native Hawaiian or Other Pacific Islander
Female","Native Hawaiian or Other Pacific Islander
Male","Native Hawaiian or Other Pacific Islander
Nonbinary","Native Hawaiian or Other Pacific Islander
Total","Two or More Races
Female","Two or More Races
Male","Two or More Races 
Nonbinary","Two or More Races 
Total","White
Female","White
Male","White
Nonbinary","White
Total",Total Teachers
2024-2025,0010,Mapleton 1,Teacher,0,0,0,0,4,2,0,6,5,4,0,9,54,18,0,72,5,0,0,5,1,0,0,1,231,88,2,321,414
2024-2025,0020,Adams 12 Five Star Schools,Teacher,7,0,0,7,26,6,0,32,6,5,0,11,162,49,0,211,0,0,0,0,23,7,0,30,1332,422,5,1759,2050
2024-2025,0030,Adams County 14,Teacher,2,1,0,3,19,6,0,25,10,8,0,18,82,27,0,109,0,0,0,0,0,0,0,0,122,53,0,175,330
2024-2025,0040,School District 27J,Teacher,9,6,0,15,18,5,0,23,10,4,0,14,95,40,0,135,5,1,0,6,7,1,0,8,800,230,0,1030,1231
2024-2025,0050,Bennett 29J,Teacher,0,0,0,0,0,1,0,1,3,2,0,5,6,2,0,8,1,0,0,1,0,0,0,0,60,18,0,78,93
2024-2025,0060,Strasburg 31J,Teacher,0,0,0,0,0,0,0,0,0,0,0,0,7,1,0,8,0,0,0,0,0,0,0,0,48,11,0,59,67
2024-2025,0070,Westminster Public Schools,Teacher,0,0,0,0,6,4,0,10,4,3,0,7,57,6,0,63,0,0,0,0,8,2,0,10,254,83,0,337,427
2024-2025,0100,Alamosa RE-11J,Teacher,0,0,0,0,0,0,0,0,0,0,0,0,36,14,0,50,0,0,0,0,0,0,0,0,61,25,0,86,136
2024-2025,0110,Sangre De Cristo Re-22J,Teacher,0,0,0,0,0,0,0,0,0,0,0,0,3,0,0,3,0,0,0,0,0,0,0,0,14,8,0,22,25
2024-2025,0120,Englewood 1,Teacher,1,0,0,1,0,0,0,0,0,0,0,0,16,1,0,17,0,0,0,0,0,0,0,0,106,46,0,152,170
2024-2025,0123,Sheridan 2,Teacher,1,0,0,1,0,0,0,0,0,0,0,0,5,3,0,8,0,0,0,0,0,0,0,0,44,16,0,60,69
2024-2025,0130,Cherry Creek 5,Teacher,6,1,0,7,61,20,0,81,57,33,0,90,205,74,2,281,0,1,0,1,61,14,1,76,2122,615,0,2737,3273
2024-2025,0140,Littleton 6,Teacher,3,2,0,5,9,1,0,10,2,3,0,5,31,6,0,37,0,0,0,0,8,0,0,8,569,150,0,719,784
2024-2025,0170,Deer Trail 26J,Teacher,0,0,0,0,1,0,0,1,1,0,0,1,0,0,0,0,0,0,0,0,0,0,0,0,20,6,0,26,28
2024-2025,0180,Adams-Arapahoe 28J,Teacher,5,2,0,7,66,19,1,86,90,48,1,139,228,70,2,300,5,0,0,5,49,13,1,63,1278,452,15,1745,2345
2024-2025,0190,Byers 32J,Teacher,1,0,0,1,5,0,0,5,6,0,0,6,7,2,0,9,0,0,0,0,0,0,0,0,122,30,0,152,173
2024-2025,0220,Archuleta County 50 Jt,Teacher,0,0,0,0,2,1,0,3,0,0,0,0,9,5,0,14,0,0,0,0,0,0,0,0,79,24,0,103,120
2024-2025,0230,Walsh RE-1,Teacher,0,0,0,0,0,0,0,0,0,0,0,0,0,0,0,0,0,0,0,0,0,0,0,0,15,2,0,17,17
2024-2025,0240,Pritchett RE-3,Teacher,0,0,0,0,0,0,0,0,0,0,0,0,0,0,0,0,0,0,0,0,0,0,0,0,11,0,0,11,11
2024-2025,0250,Springfield RE-4,Teacher,0,0,0,0,1,1,0,2,0,0,0,0,5,1,0,6,0,0,0,0,0,0,0,0,17,6,0,23,31
2024-2025,0260,Vilas RE-5,Teacher,0,0,0,0,1,0,0,1,0,0,0,0,1,0,0,1,0,0,0,0,2,0,0,2,5,0,0,5,9
2024-2025,0270,Campo RE-6,Teacher,0,0,0,0,1,0,0,1,0,0,0,0,0,0,0,0,0,0,0,0,0,0,0,0,7,0,0,7,8
2024-2025,0290,Las Animas RE-1,Teacher,0,0,0,0,1,0,0,1,1,0,0,1,2,3,0,5,0,0,0,0,0,1,0,1,22,8,0,30,38
2024-2025,0310,McClave Re-2,Teacher,3,1,0,4,0,0,0,0,0,0,0,0,0,0,0,0,0,0,0,0,0,0,0,0,13,4,0,17,21
2024-2025,0470,St Vrain Valley RE1J,Teacher,4,1,0,5,17,6,0,23,3,6,0,9,109,23,0,132,6,2,0,8,0,0,0,0,1394,400,0,1794,1971
2024-2025,0480,Boulder Valley Re 2,Teacher,4,1,0,5,20,7,0,27,5,9,0,14,129,41,0,170,1,0,0,1,17,7,0,24,1043,379,2,1424,1665
2024-2025,0490,Buena Vista R-31,Teacher,0,0,0,0,0,0,0,0,0,0,0,0,2,1,0,3,0,0,0,0,0,0,0,0,57,16,0,73,76
2024-2025,0500,Salida R-32,Teacher,0,0,0,0,1,0,0,1,0,0,0,0,8,4,0,12,1,0,0,1,0,0,0,0,61,28,0,89,103
2024-2025,0510,Kit Carson R-1,Teacher,0,0,0,0,0,0,0,0,0,0,0,0,1,0,0,1,0,0,0,0,0,0,0,0,14,2,0,16,17
2024-2025,0520,Cheyenne County Re-5,Teacher,0,0,0,0,0,0,0,0,1,0,0,1,0,0,0,0,0,0,0,0,0,0,0,0,13,3,0,16,17
2024-2025,0540,Clear Creek RE-1,Teacher,0,0,0,0,0,1,0,1,0,0,0,0,0,1,0,1,0,0,0,0,0,0,0,0,39,14,0,53,55
2024-2025,0550,North Conejos RE-1J,Teacher,0,0,0,0,0,0,0,0,0,0,0,0,11,2,0,13,0,0,0,0,0,0,0,0,41,13,0,54,67
2024-2025,0560,Sanford 6J,Teacher,0,0,0,0,0,0,0,0,0,0,0,0,0,0,0,0,0,0,0,0,0,2,0,2,20,4,0,24,26
2024-2025,0580,South Conejos RE-10,Teacher,0,0,0,0,1,0,0,1,0,0,0,0,8,3,0,11,0,0,0,0,0,0,0,0,3,4,0,7,19
2024-2025,0640,Centennial R-1,Teacher,0,0,0,0,4,1,0,5,0,0,0,0,8,1,0,9,0,0,0,0,0,0,0,0,3,0,0,3,17
2024-2025,0740,Sierra Grande R-30,Teacher,0,0,0,0,0,0,0,0,0,0,0,0,5,0,0,5,0,0,0,0,0,0,0,0,8,2,0,10,15
2024-2025,0770,Crowley County RE-1-J,Teacher,0,0,0,0,3,0,0,3,0,0,0,0,1,0,0,1,0,0,0,0,0,0,0,0,16,2,0,18,22
2024-2025,0860,Custer County School District C-1,Teacher,0,0,0,0,0,0,0,0,0,0,0,0,0,1,0,1,0,0,0,0,0,0,0,0,27,2,0,29,30
2024-2025,0870,Delta County 50(J),Teacher,0,0,0,0,1,1,0,2,1,0,0,1,9,5,0,14,0,0,0,0,0,0,0,0,184,68,0,252,269
2024-2025,0880,Denver County 1,Teacher,11,3,0,14,118,39,0,157,219,150,0,369,1047,382,1,1430,1,3,0,4,117,35,0,152,3017,1180,1,4198,6324
2024-2025,0890,Dolores County RE No.2,Teacher,0,0,0,0,0,0,0,0,0,0,0,0,1,0,0,1,0,0,0,0,0,0,0,0,18,2,0,20,21
2024-2025,0900,Douglas County Re 1,Teacher,2,3,0,5,4,2,0,6,49,4,0,53,184,36,0,220,14,7,0,21,0,0,0,0,2668,662,1,3331,3636
2024-2025,0910,Eagle County RE 50,Teacher,3,0,0,3,5,2,0,7,1,1,0,2,81,28,0,109,1,0,0,1,3,0,0,3,296,95,1,392,517
2024-2025,0920,Elizabeth School District,Teacher,3,0,0,3,0,0,0,0,2,1,0,3,4,2,0,6,1,0,0,1,0,1,0,1,112,28,0,140,154
2024-2025,0930,Kiowa C-2,Teacher,0,0,0,0,0,0,0,0,0,1,0,1,0,0,0,0,0,0,0,0,0,0,0,0,22,3,0,25,26
2024-2025,0940,Big Sandy 100J,Teacher,0,0,0,0,0,0,0,0,0,0,0,0,1,0,0,1,0,0,0,0,0,0,0,0,25,6,0,31,32
2024-2025,0950,Elbert 200,Teacher,0,0,0,0,0,0,0,0,0,0,0,0,0,0,0,0,0,0,0,0,0,0,0,0,17,7,0,24,24
2024-2025,0960,Agate 300,Teacher,0,0,0,0,0,0,0,0,0,0,0,0,0,0,0,0,0,0,0,0,0,0,0,0,6,3,0,9,9
2024-2025,0970,Calhan RJ-1,Teacher,0,0,0,0,0,0,0,0,0,0,0,0,0,1,0,1,0,0,0,0,1,0,0,1,27,9,0,36,38
2024-2025,0980,Harrison 2,Teacher,5,2,0,7,43,19,0,62,35,16,0,51,30,6,0,36,5,0,0,5,26,8,0,34,481,145,2,628,823
2024-2025,0990,Widefield 3,Teacher,6,2,0,8,1,2,0,3,13,4,0,17,12,4,0,16,4,2,0,6,23,7,0,30,384,128,0,512,592
2024-2025,1000,Fountain 8,Teacher,2,2,0,4,7,1,0,8,15,8,0,23,60,17,0,77,3,0,0,3,0,0,0,0,300,73,0,373,488
2024-2025,1010,Colorado Springs 11,Teacher,3,1,0,4,24,4,0,28,27,14,0,41,134,40,0,174,3,0,0,3,37,9,0,46,933,338,1,1272,1568
2024-2025,1020,Cheyenne Mountain 12,Teacher,1,0,0,1,0,0,0,0,1,0,0,1,5,9,0,14,0,0,0,0,2,0,0,2,182,53,0,235,253
2024-2025,1030,Manitou Springs 14,Teacher,0,0,0,0,0,0,0,0,0,0,0,0,9,1,0,10,0,0,0,0,0,0,0,0,56,32,0,88,98
2024-2025,1040,Academy 20,Teacher,4,0,0,4,33,4,0,37,15,9,0,24,99,19,0,118,2,0,0,2,18,4,0,22,1084,325,0,1409,1616
2024-2025,1050,Ellicott 22,Teacher,0,0,0,0,0,1,0,1,1,0,0,1,3,0,0,3,0,0,0,0,0,0,0,0,47,19,0,66,71
2024-2025,1060,Peyton 23 Jt,Teacher,0,0,0,0,1,0,0,1,0,0,0,0,2,1,0,3,0,0,0,0,0,0,0,0,35,4,0,39,43
2024-2025,1070,Hanover 28,Teacher,0,0,0,0,0,0,0,0,0,1,0,1,1,1,0,2,0,1,0,1,0,0,0,0,12,4,0,16,20
2024-2025,1080,Lewis-Palmer 38,Teacher,2,0,0,2,6,0,0,6,2,2,0,4,13,2,0,15,3,0,0,3,2,2,0,4,287,61,0,348,382
2024-2025,1110,District 49,Teacher,9,2,0,11,24,5,0,29,20,11,0,31,91,38,0,129,13,5,0,18,14,4,0,18,867,262,0,1129,1365
2024-2025,1120,Edison 54 JT,Teacher,0,0,0,0,0,0,0,0,0,0,0,0,0,0,0,0,0,0,0,0,1,0,0,1,5,3,0,8,9
2024-2025,1130,Miami/Yoder 60 JT,Teacher,0,0,0,0,0,0,0,0,0,0,0,0,0,1,0,1,0,0,0,0,0,0,0,0,17,4,0,21,22
2024-2025,1140,Canon City RE-1,Teacher,0,0,0,0,0,1,0,1,1,0,0,1,9,2,0,11,0,0,0,0,0,0,0,0,156,50,0,206,219
2024-2025,1150,Fremont RE-2,Teacher,0,0,0,0,2,0,0,2,0,0,0,0,2,3,0,5,0,0,0,0,0,0,0,0,58,23,0,81,88
2024-2025,1160,Cotopaxi RE-3,Teacher,0,0,0,0,0,0,0,0,0,0,0,0,1,1,0,2,0,0,0,0,0,0,0,0,9,6,0,15,17
2024-2025,1180,Roaring Fork RE-1,Teacher,2,0,0,2,2,0,0,2,1,1,0,2,53,14,0,67,0,0,0,0,0,0,0,0,253,96,0,349,422
2024-2025,1195,Garfield Re-2,Teacher,1,0,0,1,0,0,0,0,1,0,0,1,11,4,0,15,0,0,0,0,1,4,0,5,190,62,0,252,274
2024-2025,1220,Garfield 16,Teacher,0,0,0,0,2,1,0,3,1,1,0,2,2,1,0,3,0,0,0,0,0,0,0,0,56,17,0,73,81
2024-2025,1330,Gilpin County RE-1,Teacher,0,0,0,0,0,0,0,0,0,0,0,0,1,0,0,1,0,0,0,0,0,0,0,0,21,7,0,28,29
2024-2025,1340,West Grand 1-JT,Teacher,0,0,0,0,1,2,0,3,0,0,0,0,0,0,0,0,0,0,0,0,0,0,0,0,20,9,0,29,32
2024-2025,1350,East Grand 2,Teacher,0,0,0,0,0,0,0,0,1,0,0,1,3,0,0,3,0,0,0,0,0,0,0,0,82,20,0,102,106
2024-2025,1360,Gunnison Watershed RE1J,Teacher,0,0,0,0,0,0,0,0,0,0,0,0,1,3,0,4,0,0,0,0,0,0,0,0,111,34,0,145,149
2024-2025,1380,Hinsdale County RE 1,Teacher,0,0,0,0,1,0,0,1,0,0,0,0,0,0,0,0,0,0,0,0,1,0,0,1,8,2,0,10,12
2024-2025,1390,Huerfano Re-1,Teacher,0,0,0,0,0,0,0,0,0,0,0,0,6,3,0,9,0,0,0,0,1,0,0,1,17,5,0,22,32
2024-2025,1400,La Veta Re-2,Teacher,0,0,0,0,0,0,0,0,0,0,0,0,4,1,0,5,0,0,0,0,0,0,0,0,9,5,0,14,19
2024-2025,1410,North Park R-1,Teacher,0,0,0,0,0,0,0,0,0,0,0,0,0,0,0,0,0,0,0,0,0,0,0,0,9,5,0,14,14
2024-2025,1420,Jefferson County R-1,Teacher,11,3,0,14,41,13,0,54,5,5,0,10,247,84,0,331,0,2,0,2,58,16,0,74,3047,982,0,4029,4514
2024-2025,1430,Eads RE-1,Teacher,0,0,0,0,0,0,0,0,0,0,0,0,0,0,0,0,0,0,0,0,0,0,0,0,17,4,0,21,21
2024-2025,1440,Plainview RE-2,Teacher,0,0,0,0,0,0,0,0,0,0,0,0,0,0,0,0,0,0,0,0,0,0,0,0,7,2,0,9,9
2024-2025,1450,Arriba-Flagler C-20,Teacher,0,0,0,0,0,0,0,0,0,0,0,0,0,0,0,0,0,0,0,0,0,0,0,0,16,1,0,17,17
2024-2025,1460,Hi-Plains R-23,Teacher,0,0,0,0,1,0,0,1,0,0,0,0,0,0,0,0,0,0,0,0,0,0,0,0,10,5,0,15,16
2024-2025,1480,Stratton R-4,Teacher,0,0,0,0,0,0,0,0,0,0,0,0,2,0,0,2,0,0,0,0,0,0,0,0,13,3,0,16,18
2024-2025,1490,Bethune R-5,Teacher,0,0,0,0,4,0,0,4,0,0,0,0,0,0,0,0,0,0,0,0,0,0,0,0,7,3,0,10,14
2024-2025,1500,Burlington RE-6J,Teacher,0,0,0,0,4,0,0,4,0,0,0,0,4,0,0,4,2,0,0,2,0,0,0,0,25,12,0,37,47
2024-2025,1510,Lake County R-1,Teacher,0,0,0,0,0,0,0,0,0,0,0,0,3,2,0,5,0,0,0,0,0,0,0,0,42,14,0,56,61
2024-2025,1520,Durango 9-R,Teacher,11,0,0,11,3,0,0,3,0,1,0,1,11,7,0,18,2,2,0,4,0,0,0,0,252,71,0,323,360
2024-2025,1530,Bayfield 10 Jt-R,Teacher,0,0,0,0,0,0,0,0,0,0,0,0,2,0,0,2,0,0,0,0,0,0,0,0,65,32,0,97,99
2024-2025,1540,Ignacio 11 JT,Teacher,3,2,0,5,1,0,0,1,1,0,0,1,6,4,0,10,0,0,0,0,2,0,0,2,30,13,0,43,62
2024-2025,1550,Poudre R-1,Teacher,5,3,0,8,15,4,0,19,5,3,1,9,94,32,0,126,2,0,0,2,7,6,0,13,1333,446,3,1782,1959
2024-2025,1560,Thompson R2-J,Teacher,3,2,0,5,8,3,0,11,0,2,0,2,31,15,0,46,0,1,0,1,0,0,0,0,669,230,1,900,965
2024-2025,1570,Estes Park R-3,Teacher,0,0,0,0,0,0,0,0,0,0,0,0,2,2,0,4,0,0,0,0,1,0,0,1,55,17,0,72,77
2024-2025,1580,Trinidad 1,Teacher,0,0,0,0,0,0,0,0,0,0,0,0,10,2,0,12,0,0,0,0,0,0,0,0,18,14,0,32,44
2024-2025,1590,Primero Reorganized 2,Teacher,1,0,0,1,0,0,0,0,0,0,0,0,5,1,0,6,0,0,0,0,0,0,0,0,7,3,0,10,17
2024-2025,1600,Hoehne Reorganized 3,Teacher,0,0,0,0,0,0,0,0,0,0,0,0,3,1,0,4,0,0,0,0,0,0,0,0,11,5,0,16,20
2024-2025,1620,Aguilar Reorganized 6,Teacher,0,0,0,0,0,0,0,0,0,0,0,0,1,0,0,1,0,0,0,0,0,0,0,0,11,1,0,12,13
2024-2025,1750,Branson Reorganized 82,Teacher,0,0,0,0,0,0,0,0,0,0,0,0,0,0,0,0,0,1,0,1,0,0,0,0,33,2,0,35,36
2024-2025,1760,Kim Reorganized 88,Teacher,0,0,0,0,0,0,0,0,0,0,0,0,0,0,0,0,0,0,0,0,0,0,0,0,8,1,0,9,9
2024-2025,1780,Genoa-Hugo C113,Teacher,0,0,0,0,0,0,0,0,0,0,0,0,2,0,0,2,0,0,0,0,0,0,0,0,15,1,0,16,18
2024-2025,1790,Limon RE-4J,Teacher,0,0,0,0,0,0,0,0,0,0,0,0,0,0,0,0,0,0,0,0,0,0,0,0,25,9,0,34,34
2024-2025,1810,Karval RE-23,Teacher,0,0,0,0,1,0,0,1,0,0,0,0,0,0,0,0,0,0,0,0,0,0,0,0,4,1,0,5,6
2024-2025,1828,Valley RE-1,Teacher,0,0,0,0,1,2,0,3,0,0,0,0,2,2,0,4,0,0,0,0,1,0,0,1,95,24,0,119,127
2024-2025,1850,Frenchman RE-3,Teacher,0,0,0,0,0,0,0,0,0,0,0,0,0,0,0,0,0,0,0,0,0,0,0,0,17,2,0,19,19
2024-2025,1860,Buffalo RE-4J,Teacher,0,0,0,0,0,0,0,0,0,0,0,0,0,0,0,0,0,0,0,0,0,0,0,0,15,6,0,21,21
2024-2025,1870,Plateau RE-5,Teacher,0,0,0,0,0,0,0,0,0,0,0,0,0,0,0,0,0,0,0,0,0,0,0,0,13,4,0,17,17
2024-2025,1980,De Beque 49JT,Teacher,0,0,0,0,1,0,0,1,0,0,0,0,1,1,0,2,0,0,0,0,0,0,0,0,10,2,0,12,15
2024-2025,1990,Plateau Valley 50,Teacher,0,0,0,0,0,0,0,0,0,0,0,0,1,1,0,2,0,0,0,0,1,0,0,1,14,9,0,23,26
2024-2025,2000,Mesa County Valley 51,Teacher,3,0,0,3,4,2,0,6,4,2,0,6,79,31,0,110,1,0,0,1,12,8,0,20,868,283,0,1151,1297
2024-2025,2010,Creede School District,Teacher,0,0,0,0,0,0,0,0,0,0,0,0,0,0,0,0,0,0,0,0,0,0,0,0,13,4,0,17,17
2024-2025,2020,Moffat County RE: No 1,Teacher,0,0,0,0,0,0,0,0,0,0,0,0,10,1,0,11,0,0,0,0,0,0,0,0,96,29,0,125,136
2024-2025,2035,Montezuma-Cortez RE-1,Teacher,2,0,0,2,20,4,0,24,1,0,0,1,11,5,1,17,0,0,0,0,0,0,0,0,85,26,0,111,155
2024-2025,2055,Dolores RE-4A,Teacher,0,0,0,0,0,0,0,0,0,0,0,0,3,0,0,3,0,0,0,0,1,0,0,1,37,12,0,49,53
2024-2025,2070,Mancos Re-6,Teacher,0,0,0,0,0,0,0,0,0,0,0,0,2,0,0,2,0,0,0,0,0,0,0,0,26,7,0,33,35
2024-2025,2180,Montrose County RE-1J,Teacher,4,1,0,5,2,0,0,2,1,0,0,1,0,0,0,0,2,0,0,2,0,0,0,0,271,78,0,349,359
2024-2025,2190,West End RE-2,Teacher,0,0,0,0,0,0,0,0,0,0,0,0,0,0,0,0,0,1,0,1,0,0,0,0,14,4,0,18,19
2024-2025,2395,Brush RE-2(J),Teacher,0,0,0,0,2,2,0,4,1,0,0,1,6,5,0,11,0,0,0,0,0,0,0,0,53,14,0,67,83
2024-2025,2405,Fort Morgan Re-3,Teacher,1,0,0,1,23,6,0,29,0,1,0,1,38,3,0,41,0,0,0,0,0,0,0,0,120,41,0,161,233
2024-2025,2505,Weldon Valley RE-20(J),Teacher,0,0,0,0,0,1,0,1,0,0,0,0,0,0,0,0,0,0,0,0,0,0,0,0,14,4,0,18,19
2024-2025,2515,Wiggins RE-50(J),Teacher,0,1,0,1,0,0,0,0,1,0,0,1,4,1,0,5,0,0,0,0,0,0,0,0,36,13,0,49,56
2024-2025,2520,East Otero R-1,Teacher,0,0,0,0,5,0,0,5,0,1,0,1,12,0,0,12,0,0,0,0,0,0,0,0,52,18,0,70,88
2024-2025,2530,Rocky Ford R-2,Teacher,0,0,0,0,2,1,0,3,1,0,0,1,12,4,0,16,0,0,0,0,0,1,0,1,22,8,0,30,51
2024-2025,2535,Manzanola 3J,Teacher,0,0,0,0,0,1,0,1,0,0,0,0,2,2,0,4,0,0,0,0,0,0,0,0,9,1,0,10,15
2024-2025,2540,Fowler R-4J,Teacher,0,0,0,0,0,0,0,0,0,0,0,0,4,1,0,5,0,0,0,0,1,0,0,1,20,10,0,30,36
2024-2025,2560,Cheraw 31,Teacher,0,0,0,0,0,0,0,0,0,0,0,0,0,0,0,0,0,0,0,0,0,0,0,0,9,5,0,14,14
2024-2025,2570,Swink 33,Teacher,1,0,0,1,0,0,0,0,0,0,0,0,0,0,0,0,0,0,0,0,0,0,0,0,23,2,0,25,26
2024-2025,2580,Ouray R-1,Teacher,0,0,0,0,0,0,0,0,0,0,0,0,0,0,0,0,0,0,0,0,0,1,0,1,18,3,0,21,22
2024-2025,2590,Ridgway R-2,Teacher,0,0,0,0,0,0,0,0,0,0,0,0,0,0,0,0,0,0,0,0,0,0,0,0,22,11,0,33,33
2024-2025,2600,Platte Canyon 1,Teacher,0,0,0,0,0,0,0,0,0,0,0,0,1,2,0,3,0,0,0,0,0,0,0,0,34,17,0,51,54
2024-2025,2610,Park County RE-2,Teacher,0,0,0,0,0,1,0,1,0,0,0,0,1,1,0,2,0,0,0,0,0,0,0,0,28,6,0,34,37
2024-2025,2620,Holyoke Re-1J,Teacher,0,0,0,0,1,0,0,1,0,0,0,0,2,1,0,3,0,0,0,0,2,0,0,2,36,2,0,38,44
2024-2025,2630,Haxtun RE-2J,Teacher,0,0,0,0,0,0,0,0,0,0,0,0,0,0,0,0,0,0,0,0,0,0,0,0,19,5,0,24,24
2024-2025,2640,Aspen 1,Teacher,0,0,0,0,3,0,0,3,1,0,0,1,2,2,0,4,0,0,0,0,0,0,0,0,83,40,0,123,131
2024-2025,2650,Granada RE-1,Teacher,0,0,0,0,1,0,0,1,0,0,0,0,2,2,0,4,0,0,0,0,1,0,0,1,13,2,0,15,21
2024-2025,2660,Lamar Re-2,Teacher,0,0,0,0,0,0,0,0,0,0,0,0,16,2,0,18,0,0,0,0,0,0,0,0,63,14,0,77,95
2024-2025,2670,Holly RE-3,Teacher,0,0,0,0,1,0,0,1,0,0,0,0,3,0,0,3,0,0,0,0,0,0,0,0,13,3,0,16,20
2024-2025,2680,Wiley RE-13 Jt,Teacher,0,0,0,0,1,0,0,1,0,0,0,0,0,0,0,0,0,0,0,0,0,0,0,0,24,1,0,25,26
2024-2025,2690,Pueblo City 60,Teacher,2,0,0,2,4,1,0,5,9,5,0,14,202,79,0,281,0,0,0,0,7,5,0,12,394,155,0,549,863
2024-2025,2700,Pueblo County 70,Teacher,2,1,0,3,3,1,0,4,2,5,0,7,94,32,0,126,1,0,0,1,0,0,0,0,337,91,0,428,569
2024-2025,2710,Meeker RE-1,Teacher,0,0,0,0,0,0,0,0,0,0,0,0,0,0,0,0,0,0,0,0,0,0,0,0,38,11,0,49,49
2024-2025,2720,Rangely RE-4,Teacher,0,0,0,0,0,1,0,1,1,0,0,1,0,0,0,0,0,0,0,0,0,0,0,0,23,14,0,37,39
2024-2025,2730,Upper Rio Grande School District C-7,Teacher,0,0,0,0,0,0,0,0,0,0,0,0,5,5,0,10,0,0,0,0,0,0,0,0,20,7,0,27,37
2024-2025,2740,Monte Vista C-8,Teacher,0,0,0,0,0,0,0,0,0,0,0,0,13,11,0,24,0,0,0,0,0,0,0,0,33,20,0,53,77
2024-2025,2750,Sargent RE-33J,Teacher,0,0,0,0,2,0,0,2,0,0,0,0,0,0,0,0,0,0,0,0,0,0,0,0,17,6,0,23,25
2024-2025,2760,Hayden RE-1,Teacher,0,0,0,0,4,1,0,5,0,0,0,0,2,0,0,2,0,0,0,0,0,0,0,0,18,10,0,28,35
2024-2025,2770,Steamboat Springs RE-2,Teacher,2,0,0,2,3,1,0,4,0,0,0,0,1,1,0,2,0,0,0,0,0,0,0,0,142,51,0,193,201
2024-2025,2780,South Routt RE 3,Teacher,0,0,0,0,0,0,0,0,0,0,0,0,0,0,0,0,0,0,0,0,0,0,0,0,23,4,0,27,27
2024-2025,2790,Mountain Valley RE 1,Teacher,1,0,0,1,1,1,0,2,0,0,0,0,0,1,0,1,0,0,0,0,0,0,0,0,5,4,0,9,13
2024-2025,2800,Moffat 2,Teacher,0,0,0,0,1,0,0,1,0,0,0,0,2,0,0,2,0,0,0,0,0,0,0,0,10,5,0,15,18
2024-2025,2810,Center 26 JT,Teacher,0,0,0,0,2,0,0,2,0,0,0,0,10,5,0,15,0,0,0,0,0,0,0,0,22,8,0,30,47
2024-2025,2820,Silverton 1,Teacher,0,0,0,0,0,0,0,0,0,0,0,0,0,0,0,0,0,0,0,0,0,0,0,0,7,1,0,8,8
2024-2025,2830,Telluride R-1,Teacher,0,0,0,0,1,0,0,1,0,0,0,0,9,4,0,13,0,0,0,0,0,0,0,0,44,12,0,56,70
2024-2025,2840,Norwood R-2J,Teacher,0,0,0,0,0,0,0,0,0,0,0,0,0,0,0,0,0,0,0,0,0,0,0,0,13,5,0,18,18
2024-2025,2862,Julesburg Re-1,Teacher,0,0,0,0,0,1,0,1,0,0,0,0,2,0,0,2,0,0,0,0,0,0,0,0,21,6,0,27,30
2024-2025,2865,Revere School District,Teacher,0,0,0,0,0,0,0,0,0,0,0,0,0,0,0,0,0,0,0,0,0,0,0,0,13,5,0,18,18
2024-2025,3000,Summit RE-1,Teacher,1,0,0,1,1,1,0,2,0,0,0,0,28,5,0,33,1,0,0,1,1,0,0,1,195,58,0,253,291
2024-2025,3010,Cripple Creek-Victor RE-1,Teacher,0,0,0,0,1,0,0,1,0,0,0,0,0,0,0,0,0,0,0,0,0,0,0,0,15,3,0,18,19
2024-2025,3020,Woodland Park Re-2,Teacher,0,0,0,0,1,0,0,1,2,0,0,2,0,0,0,0,0,0,0,0,1,0,0,1,103,28,0,131,135
2024-2025,3030,Akron R-1,Teacher,0,0,0,0,0,0,0,0,0,0,0,0,0,0,0,0,0,0,0,0,0,0,0,0,31,6,0,37,37
2024-2025,3040,Arickaree R-2,Teacher,0,0,0,0,0,0,0,0,0,0,0,0,0,0,0,0,0,0,0,0,0,0,0,0,7,3,0,10,10
2024-2025,3050,Otis R-3,Teacher,0,0,0,0,0,0,0,0,0,0,0,0,0,0,0,0,0,0,0,0,0,0,0,0,13,6,0,19,19
2024-2025,3060,Lone Star 101,Teacher,0,0,0,0,0,0,0,0,0,0,0,0,0,0,0,0,0,0,0,0,0,0,0,0,13,0,0,13,13
2024-2025,3070,Woodlin R-104,Teacher,0,0,0,0,3,0,0,3,0,0,0,0,0,1,0,1,0,0,0,0,0,0,0,0,6,1,0,7,11
2024-2025,3080,Weld County RE-1,Teacher,1,1,0,2,2,0,0,2,1,0,0,1,15,3,1,19,0,0,0,0,0,0,0,0,84,22,0,106,130
2024-2025,3085,Eaton RE-2,Teacher,0,0,0,0,0,0,0,0,0,0,0,0,4,3,0,7,0,0,0,0,0,0,0,0,99,22,0,121,128
2024-2025,3090,Weld County School District RE-3J,Teacher,0,0,0,0,3,1,0,4,1,0,0,1,13,2,0,15,3,0,0,3,0,0,0,0,114,38,0,152,175
2024-2025,3100,Weld RE-4,Teacher,0,0,0,0,5,1,0,6,3,2,0,5,17,6,0,23,0,0,0,0,7,1,0,8,379,110,0,489,531
2024-2025,3110,Johnstown-Milliken RE-5J,Teacher,0,0,0,0,2,0,0,2,0,0,0,0,21,7,0,28,2,0,0,2,0,0,0,0,159,45,0,204,236
2024-2025,3120,Greeley 6,Teacher,6,0,0,6,22,7,0,29,4,9,0,13,136,47,0,183,2,1,0,3,1,0,0,1,793,243,0,1036,1271
2024-2025,3130,Platte Valley RE-7,Teacher,1,0,0,1,0,0,0,0,0,1,0,1,5,0,0,5,0,0,0,0,0,0,0,0,61,15,0,76,83
2024-2025,3140,Weld Re-8 Schools,Teacher,2,1,0,3,3,0,0,3,1,1,0,2,23,8,0,31,0,0,0,0,0,0,0,0,77,33,0,110,149
2024-2025,3145,Ault-Highland RE-9,Teacher,0,0,0,0,0,0,0,0,0,0,0,0,4,2,0,6,0,0,0,0,0,0,0,0,43,15,0,58,64
2024-2025,3146,Briggsdale RE-10,Teacher,0,0,0,0,0,0,0,0,0,0,0,0,0,0,0,0,0,0,0,0,0,0,0,0,11,8,0,19,19
2024-2025,3147,Prairie RE-11,Teacher,0,0,0,0,0,0,0,0,0,0,0,0,0,0,0,0,0,0,0,0,12,5,0,17,1,0,0,1,18
2024-2025,3148,Pawnee RE-12,Teacher,0,0,0,0,0,0,0,0,0,0,0,0,0,0,0,0,0,0,0,0,0,0,0,0,7,4,0,11,11
2024-2025,3200,Yuma 1,Teacher,0,0,0,0,0,0,0,0,0,0,0,0,3,1,0,4,0,0,0,0,0,0,0,0,51,7,0,58,62
2024-2025,3210,Wray RD-2,Teacher,0,0,0,0,1,2,0,3,0,0,0,0,3,0,0,3,0,0,0,0,0,0,0,0,34,9,0,43,49
2024-2025,3220,Idalia RJ-3,Teacher,0,0,0,0,0,0,0,0,0,0,0,0,0,0,0,0,0,0,0,0,0,0,0,0,14,2,0,16,16
2024-2025,3230,Liberty J-4,Teacher,0,0,0,0,0,0,0,0,0,0,0,0,0,0,0,0,0,0,0,0,0,0,0,0,11,1,0,12,12
2024-2025,8001,Charter School Institute,Teacher,9,3,0,12,28,7,0,35,29,10,0,39,129,51,0,180,3,1,0,4,11,1,0,12,672,280,0,952,1234
2024-2025,8104,Division of Youth Services,Teacher,0,0,0,0,0,0,0,0,0,1,0,1,2,0,0,2,0,0,0,0,1,0,0,1,7,10,0,17,21
2024-2025,9000,Colorado School for the Deaf and Blind,Teacher,0,0,0,0,0,1,0,1,1,0,0,1,2,1,0,3,0,0,0,0,1,0,0,1,20,6,0,26,32
2024-2025,9025,East Central BOCES,Teacher,0,0,0,0,0,0,0,0,1,1,0,2,0,0,0,0,0,0,0,0,0,0,0,0,10,2,0,12,14
2024-2025,9035,Centennial BOCES,Teacher,0,0,0,0,0,0,0,0,0,0,0,0,2,0,0,2,0,0,0,0,0,0,0,0,10,1,0,11,13
2024-2025,9040,Northeast BOCES,Teacher,0,0,0,0,0,0,0,0,0,0,0,0,0,0,0,0,0,0,0,0,0,0,0,0,4,1,0,5,5
2024-2025,9045,Pikes Peak BOCES,Teacher,0,0,0,0,0,0,0,0,0,0,0,0,3,0,0,3,0,0,0,0,0,1,0,1,4,0,0,4,8
2024-2025,9050,San Juan BOCES,Teacher,0,0,0,0,0,0,0,0,0,0,0,0,0,0,0,0,0,0,0,0,1,0,0,1,3,3,0,6,7
2024-2025,9055,San Luis Valley BOCES,Teacher,0,0,0,0,2,2,0,4,0,0,0,0,4,1,0,5,0,0,0,0,0,0,0,0,2,1,0,3,12
2024-2025,9060,South Central BOCES,Teacher,0,0,0,0,0,0,0,0,0,0,0,0,0,0,0,0,0,0,0,0,0,0,0,0,3,0,0,3,3
2024-2025,9075,Southeastern BOCES,Teacher,0,0,0,0,0,0,0,0,0,0,0,0,0,0,0,0,0,0,0,0,0,0,0,0,1,0,0,1,1
2024-2025,9130,Expeditionary BOCES,Teacher,1,0,0,1,1,0,0,1,0,0,0,0,0,0,0,0,0,0,0,0,0,0,0,0,17,5,0,22,24
2024-2025,9140,Blue Sky BOCES,Teacher,0,0,0,0,0,0,0,0,0,0,0,0,0,0,0,0,0,0,0,0,0,0,0,0,7,0,0,7,7
2024-2025,9145,Uncompahgre BOCES,Teacher,0,0,0,0,0,0,0,0,0,0,0,0,0,0,0,0,0,0,0,0,0,0,0,0,1,0,0,1,1
2024-2025,9150,Santa Fe Trail BOCES,Teacher,0,0,0,0,0,0,0,0,0,0,0,0,0,0,0,0,0,0,0,0,0,0,0,0,3,0,0,3,3
2024-2025,9165,Ute Pass BOCES,Teacher,0,0,0,0,0,0,0,0,0,0,0,0,1,0,0,1,0,0,0,0,0,0,0,0,1,1,0,2,3
2024-2025,9170,Education reEnvisioned BOCES,Teacher,0,0,0,0,3,1,0,4,3,1,0,4,17,4,0,21,1,0,0,1,2,1,0,3,204,43,0,247,280
2024-2025,9175,Colorado River BOCES,Teacher,0,0,0,0,0,0,0,0,0,0,0,0,0,0,0,0,0,0,0,0,0,0,0,0,10,5,0,15,15